{"AA":	"IN",
"AB":	"IN",
"AF":	"AD",
"DA":	"IN",
"DG":	"CM",
"DR":	"IN",
"DZ":	"PM",
"KA":	"DM",
"KG":	"CM",
"KP":	"AD",
"KR":	"IN",
"KZ":	"PM",
"ML":	"PM",
"PR":	"AD",
"RE":	"IN",
"RV":	"IN",
"SA":	"IN",
"SB":	"IN",
"WA":	"AD",
"WE":	"DM",
"WI":	"AD",
"WL":	"AD",
"ZE":	"PM",
"ZP":	"PM",
"ZR":	"PM",
"ZV":	"PM"}